0000000000
0000000000
0000000000
00000##000
0000##0000
0000000000
0000000000
0000000000
00###00000
0000000000
