1111111111
1111111111
1111111111
1111100111
1111001111
1111111111
1111111111
1111111111
1100011111
1111111111
