111111111111111
111111111111111
110101110111111
111111110001111
101110110101111
110001111101111
111111111100111
111111111101111
111111111101111
111111111111111
111111111111111
111111111111111
